4 4 4 4 4 4 4 4 4 4 4 4 4 4 4 4 4 4 4 4 4 4 4 4 4
5 1 1 1 0 1 1 1 1 1 1 1 1 1 1 1 1 1 1 1 1 1 1 1 5
5 1 0 0 1 1 0 1 1 2 1 1 1 9 1 0 1 0 1 1 2 2 1 1 5
5 1 1 1 1 1 1 1 0 9 1 1 2 1 0 0 1 1 6 7 2 1 1 1 5
5 1 1 3 0 1 1 1 0 1 1 2 1 0 1 1 1 1 10 11 1 1 1 1 5
5 1 1 1 1 0 1 1 1 2 1 1 1 1 1 1 1 1 1 1 2 1 1 1 5
5 1 2 9 1 1 1 2 1 0 0 1 1 8 1 1 2 1 1 2 2 2 1 1 5
5 1 0 2 1 0 1 1 1 1 1 1 1 1 1 0 1 1 1 1 1 1 1 1 5
5 1 1 1 1 1 1 1 1 2 1 1 3 1 2 1 1 2 2 1 1 9 1 1 5
5 1 0 1 0 1 1 1 1 2 2 1 1 1 1 1 2 1 1 1 1 1 1 1 5
5 1 1 1 1 6 7 1 1 1 1 1 1 1 1 1 1 1 1 1 3 1 1 1 5
5 1 2 0 1 10 11 1 1 1 9 1 1 0 1 2 1 1 1 2 1 1 1 1 5
5 1 1 1 1 1 1 1 2 1 1 1 1 0 0 1 1 1 1 1 1 1 1 1 5
5 1 1 0 1 1 2 1 1 1 1 1 1 0 2 1 1 2 1 1 1 1 1 1 5
5 1 1 1 1 1 1 2 1 1 1 0 2 1 1 1 1 1 1 2 1 1 1 1 5
5 1 1 0 1 1 2 1 1 1 0 0 1 1 1 1 2 1 1 1 1 0 1 1 5
5 1 1 0 8 1 1 1 1 1 1 6 7 1 1 1 1 1 1 0 1 1 1 1 5
5 1 1 1 0 1 3 1 0 0 1 10 11 1 1 1 1 8 1 1 1 1 8 1 5
5 1 0 1 1 1 1 1 1 1 1 1 1 1 1 0 0 0 1 1 1 1 1 1 5
4 4 4 4 4 4 4 4 4 4 4 4 4 4 4 4 4 4 4 4 4 4 4 4 4